- - - - - - - - - - - - - - - - - - - - - - - - - - - - - - -
|                           |                           |   B
- - - - - - -   - - - - -   - - -   - - - - - - - - -   -   -
|               |       |   |       |               |       |
-   - - - - - - -   -   -   -   - - -   - - - - -   - - -   -
|       |           |   |       |       |   |       |       |
- - -   -   -   - - - - - - - - - - -   -   -   - - -   - - -
|       |   |               |           |   |       |   |   |
-   - - -   - - - - -   -   - - -   - - -   - - -   -   -   -
|   |   |       |       |           |               |   |   |
-   -   - - -   -   - - - - - - - - -   - - - - - - -   -   -
|   |           |   |       |               |       |       |
-   -   - - - - -   -   -   - - - - - - -   -   -   - - -   -
|   |   |       |       |           |       |   |       |   |
-   -   - - -   - - - - - - - - -   -   - - - - -   - - -   -
|   |               |               |   |           |       |
-   - - - - - - -   -   - - - - - - -   -   - - - - -   - - -
|   |               |   |       |       |   |           |   |
-   -   - - - - - - -   -   - - -   - - -   -   - - - - -   -
|   |       |       |   |                   |   |           |
-   - - -   -   - - -   -   - - - - - - - - -   -   - - -   -
|       |       |       |       |               |       |   |
- - -   - - - - -   - - - - - - -   - - - - - - - - -   - - -
|       |       |                   |               |       |
-   - - -   -   -   - - - - - - -   -   - - - - -   - - -   -
|           |   |       |       |   |       |               |
-   - - - - -   - - - - -   -   -   - - -   - - - - - - - - -
|   |       |   |           |   |           |       |       |
-   -   -   -   -   - - - - -   - - - - - - -   -   -   -   -
|       |   |               |                   |       |   |
- A - - - - - - - - - - - - - - - - - - - - - - - - - - - - -
