- - - - - - - - - - - - - - - - - - - - -
|                       |       |       B
-   -   - - - - - - -   -   -   -   - - -
|   |   |                   |   |       |
- - -   - - - - -   - - - - -   - - -   -
|       |       |   |       |           |
-   - - -   -   - - -   -   - - - - -   -
|           |           |       |   |   |
-   - - - - - - - - - - - - -   -   -   -
|       |   |       |           |   |   |
- - -   -   -   -   -   - - - - -   -   -
|   |   |   |   |   |   |               |
-   -   -   -   -   -   - - - - - - -   -
|   |       |   |       |           |   |
-   - - -   -   - - - - -   - - -   -   -
|       |   |       |       |   |   |   |
- - -   -   - - -   -   - - -   -   -   -
|       |   |       |   |       |   |   |
-   - - -   -   - - -   - - -   -   - - -
|           |                   |       |
- A - - - - - - - - - - - - - - - - - - -
