+------------+
|            |
|A | +-------+
|--+         |
|   +--+---+ |
| |    |   | |
| |    | | | |
| |    | | + |
|B|      |   |
+--------+---+
