+-----------+
|A          |
+--| |------|
|           |
|   |----|  |
|   |    |  |
|        |B |
+--------+--+
