+------+-----------+
|      |           |
| +--- | +-------- |
|A|    | |         |
+-+  --+ | --------+
|        |         |
|----------------+ |
|                | |
| ----------+ ---+ |
|           |      |
|---------+ +------+
|           |      |
| +---------+ +--+ |
| |         | |    |
|     |     | | +--+
+---+ +-----+ | |  |
|   |         |    |
| | ----------+--+ |
|B|                |
+------------------+
