+---+---------------+---------------+-----------+-------------------+---+
| A |               |               |           |                   | B |
|   |   --------+   |   +---+   ----+---+   ----+   +---+   +----   |   |
|               |       |   |           |           |   |   |       |   |
+-------+   +   +-------+   +--------   +----   +   |   |   +-------+   |
|       |   |               |           |   |   |   |   |           |   |
|   +   +---+--------   +   |   --------+   +---|   |   +---+----   |   |
|   |               |   |   |       |           |           |       |   |
|   +-------+----   +---|   +---+   |   ----+   +-------+   |   ----+   |
|           |       |   |       |   |       |           |   |           |
|   ----+   +---+   |   +----   |   +---+---+   +   +   |   +---+-------+
|       |       |   |   |       |       |       |   |   |       |       |
+-------+---+   |   |   |   +---+---+   |   ----+   |   +---+   +----   |
|           |   |           |       |   |       |   |       |           |
|   +----   |   +-------+   +----   |   +---+   +---+   ----+-------+   |
|   |       |           |           |       |   |   |               |   |
|   |   ----+---+   +   +---+   +---+----   |   |   +-------+---+   |   |
|   |           |   |   |   |   |           |               |   |       |
|   +--------   |   |   |   +---|   +-------|   +-------+   |   +-------+
|   |       |   |   |           |           |   |       |               |
|   |   ----+   +---+   +----   +--------   +---+   +   +--------   +   |
|   |                   |           |               |               |   |
+---+-------------------+-----------+---------------+---------------+---+
