+-----------------+
|A|     |     |   |
| | | | | --+ | | |
| | | | |   |   | |
| +-+ | | | +---+ |
| |   | | | |     |
| | +-+ +-+ +---+ |
|   | |   | |   | |
|---+ +-+ | | | +-+
|       | |   |   |
| | --+-+ | +-+-- |
| |   |   | |     |
| +-+ | +-+ | +-+ |
|   |   |   |   | |
+-- +---+---+-+ | |
|   |         | | |
| --+---+ +-- | | |
|         |     |B|
+---------+-------+
